sssssssssss
s       s s
s       s s
s    g    s
s s       s
s s       s
sssssssssss
